S..#####.#..###...#####.#..###
.#.....#.##.#...#.....#.##.#..
..##.#...#....#..##.#...#....#
#...####...#####...####...####
...#.....###..#...#.....###..#
##.#######...####.####.##...##
...###....#####...###.....####
.#...##.#.#...#.#...##.#.#...#
.##.#...#...###.##.#...#...###
###..####.########..####.#####
###.##.#..##..####.##.#..##..#
#...#....##..###...#..#.##..##
..#...#.....###..#...#.....###
####..##.##.#######..##.##.###
#....###..#....#....###..#...E